Afrikaans	af
Albanian	sq
Arabic	ar
Aragonese	an
Armenian	hy
Asturian	ast
Azerbaijani	az
Bashkir	ba
Basque	eu
Bavarian	bar
Belarusian	be
Bengali	bn
Bishnupriya Manipuri	bpy
Bosnian	bs
Breton	br
Bulgarian	bg
Burmese	my
Catalan	ca
Cebuano	ceb
Chechen	ce
Chinese	zh
Chuvash	cv
Croatian	hr
Czech	cs
Danish	da
Dutch	nl
English	en
Estonian	et
Finnish	fi
French	fr
Galician	gl
Georgian	ka
German	de
Greek	el
Gujarati	gu
Haitian	ht
Hebrew	he
Hindi	hi
Hungarian	hu
Icelandic	is
Ido	io
Indonesian	id
Irish	ga
Italian	it
Japanese	ja
Javanese	jv
Kannada	kn
Kazakh	kk
Kirghiz	ky
Korean	ko
Latin	la
Latvian	lv
Lithuanian	lt
Lombard	lmo
Low Saxon	nds
Luxembourgish	lb
Macedonian	mk
Malagasy	mg
Malay	ms
Malayalam	ml
Marathi	mr
Minangkabau	min
Nepali	ne
Newar	new
Norwegian (Bokmal)	no
Norwegian (Nynorsk)	nn
Occitan	oc
Persian (Farsi)	fa
Piedmontese	pms
Polish	pl
Portuguese	pt
Punjabi	pa
Romanian	ro
Russian	ru
Scots	sco
Serbian	sr
Serbo-Croatian	sh
Sicilian	scn
Slovak	sk
Slovenian	sl
South Azerbaijani	azb
Spanish	es
Sundanese	su
Swahili	sw
Swedish	sv
Tagalog	tl
Tajik	tg
Tamil	ta
Tatar	tt
Telugu	te
Turkish	tr
Ukrainian	uk
Urdu	ur
Uzbek	uz
Vietnamese	vi
Volap√ºk	vo
Waray-Waray	war
Welsh	cy
West Frisian	fy
Western Punjabi	pnb
Yoruba	yo
